&&&&&&&&&&&&&&&&&&&&
&!  ~     %    |~~ &
&     ~~|||||      &
&        H         &
&                  &
&                  &
&                  &
&                  &
&        #         &
&&&  &&&&&%&&&  |&&&
&|&  ~&&&& &&&  &&&&
&       |  ~~      &
&                  &
&  #           #   &
&      &&  &&      &
&      & %% &      &
&      &&&&&&      &
&                  &
&     #   %  #     &
&&&&&&&&&&&&&&&&&&&&