&&&&&&&&&&&&&&&&&&&&
&   %            H &
&               |  &
&   ~              &
&         %        &
&   #       |      &
&        ~|        &
&       %      #   &
&   |         |    &
&    |             &
&             ~    &
&     #    %       &
&            |     &
&   |       %      &
&                  &
&     |       #~   &
&   ~              &
&        |    ~    &
&  #     !   ~     &
&&&&&&&&&&&&&&&&&&&&