&&&&&&&&&&&&&&&&&&&&
&   %              &
&       #     |    &
&             ~|   &
&         %        &
&   #              &
&                  &
&       %          &
&   |     !        &
&    |             &
&                  &
&     #    %       &
&            |     &
&           %      &
&    #             &
&        #     ~   &
&   ~              &
&             ~    &
&      H           &
&&&&&&&&&&&&&&&&&&&&