&&&&&&&&&&&&&&&&&&&&
&&&&&&&&&&&&&&&&&&&&
&%       H        %&
&&                &&
&&                &&
&&                &&
&&                &&
&&                &&
&&       %        &&
&&      #&#       &&
&&      &!&       &&
&&      # #       &&
&&                &&
&&                &&
&&                &&
&&                &&
&&                &&
&%       #        %&
&&&&&&&&&&&&&&&&&&&&
&&&&&&&&&&&&&&&&&&&&