&&&&&&&&&&&&&&&&&&&&
&|       &       !|&
&        %         &
&       ~~~        &
&  ##   ~&~        &
&       ~&~        &
& %     ~~~  #     &
&                  &
&   &    &     &   &
&        &        %&
&                  &
&        &         &
&        &         &
&        %         &
&        &         &
&&&    &&&&&&&   &&&
&        &     #   &
&        &         &
&H       &       %|&
&&&&&&&&&&&&&&&&&&&&