&&&&&&&&&&&&&&&&&&&&
&|    |& ! &|     |&
&|    |&   &|     |&
&&&&&&&&   &&&&&&&&&
&                  &
&%    ~&   &~     %&
&&&&&&&&   &&&&&&&&&
&|       #        |&
&  ~  |     |  ~   &
&|       %        |&
&  ~  |     |  ~   &
&  ~           ~   &
&  #  ~     ~   #  &
&&&&&&&&   &&&&&&&&&
&|    |&   &|     |&
&                  &
&      &   &       &
&     ~&   &~      &
&%  # ~& H &~   # %&
&&&&&&&&&&&&&&&&&&&&