&&&&&&&&&&&&&&&&&&&&
&~||||||||||||||||~&
&~       %     ~  ~&
&~                ~&
&~   ~            ~&
&~                ~&
&~   |      ~     ~&
&~       %        ~&
&~     || ||      ~&
&~     | H |      ~&
&~     |||||   |  ~&
&~       %        ~&
&~  |             ~&
&~ %              ~&
&~                ~&
&~     ~       %  ~&
&~  #    #     #  ~&
&~    #  !  #  |  ~&
&~||||||||||||||||~&
&&&&&&&&&&&&&&&&&&&&