&&&&&&&&&&&&&&&&&&&&
&  ~              !&
&  %         ~~    &
&   ||             &
&        H         &
&       &&&&&      &
&        |||       &
& ~~               &
&          %   ~   &
&    ~    |    #   &
&  #               &
&              |   &
& |      ~         &
&  %     &&        &
& ~      &&        &
&        #     ~   &
&    |~~~&&~~~|    &
&   #|~~~&&~~~|#   &
&  % |~~~&&~~~|~ % &
&&&&&&&&&&&&&&&&&&&&