&&&&&&&&&&&&&&&&&&&&
& |||~~~~        # &
& ! |~~ %          &
& # |              &
&                  &
&        ~||~      &
&        |~~~      &
&         # %      &
&                  &
&                  &
&      ~~~~|       &
&      ~~|~~~      &
&     ##|| %       &
&                  &
&                  &
&  ~~              &
&  |             % &
&  %         ||~~||&
&         | H ~~~~|&
&&&&&&&&&&&&&&&&&&&&