&&&&&&&&&&&&&&&&&&&&
&%       #        %&
&                  &
&                  &
&                  &
&                  &
&#       H        #&
&        !         &
&        %         &
&                  &
&                  &
&%       #        %&
&&&&&&&&&&&&&&&&&&&&
&## ### # ### ## ##&
&%%%%%%%%%%%%%%%%%%&
&%%%%%%%%%%%%%%%%%%&
&%%%%%%%%%%%%%%%%%%&
&%%%%%%%%%%%%%%%%%%&
&%%%%%%%%%%%%%%%%%%&
&&&&&&&&&&&&&&&&&&&&