&&&&&&&&&&&&&&&&&&&&
&   %              &
&       #     |    &
& ||||        ~|   &
&         %        &
&   #              &
&        |||    #  &
&       %   ~~     &
&   |     !        &
&    |         ~~  &
&                  &
&     #    %       &
&  ~         |     &
&    ||~    %      &
&    #             &
&        #     ~   &
&   ~          |   &
&             ~    &
& ||   H           &
&&&&&&&&&&&&&&&&&&&&